============
I    HH    I
I    ++    I
I-        -I
I          I
I --    -- I
I          I
I   ----   I
I          I
I   >><<   I
I          I
I <<    >> I
I          I
I-   HH   -I
I    ++    I
I-        -I
I          I
I <<    >> I
I          I
I   ----   I
I          I
I   <<>>   I
I          I
I >>    << I
I    HH    I
I<   ++   >I
I          I
------------
~~~~~~~~~~~~
xxxxxxxxxxxx